{
    "start": [4,1],
    "end": [4,13],
    "x_btn": [],
    "o_btn": [],
    "split_btn": [
        [4,4,[[1,10],[7,10]]]
    ],
    "map": [
        [0,0,0,0,0,0,0,0,0,1,1,1,0,0,0],
        [0,0,0,0,0,0,0,0,0,1,1,1,0,0,0],
        [0,0,0,0,0,0,0,0,0,1,1,1,0,0,0],
        [1,1,1,1,1,1,0,0,0,1,1,1,1,1,1],
        [1,1,1,1,1,1,0,0,0,1,1,1,1,1,1],
        [1,1,1,1,1,1,0,0,0,1,1,1,1,1,1],
        [0,0,0,0,0,0,0,0,0,1,1,1,0,0,0],
        [0,0,0,0,0,0,0,0,0,1,1,1,0,0,0],
        [0,0,0,0,0,0,0,0,0,1,1,1,0,0,0]
    ]
}