{
    "start": [7,1],
    "end": [3,11],
    "x_btn": [
        [6,2,[[4,8,"unhide"],[4,9,"unhide"]]]
    ],
    "o_btn": [
        [2,4,[[4,8,"toggle"],[4,9,"toggle"],[2,13,"toggle"],[3,13,"toggle"]]],
        [8,8,[[6,4,"hide"],[6,5,"hide"],[3,7,"unhide"]]]
    ],
    "split_btn": [],
    "map": [
        [0,0,1,1,0,0,0,0,0,0,0,0,0,0],
        [0,0,1,1,1,0,0,0,0,0,0,0,0,0],
        [0,0,1,1,1,0,0,0,0,0,1,1,1,0],
        [0,0,0,1,1,1,1,0,0,0,1,1,1,0],
        [0,0,0,0,0,0,1,1,0,0,1,1,1,0],
        [0,1,1,0,0,0,1,1,0,0,0,0,0,0],
        [1,1,1,1,1,1,1,1,0,0,0,0,0,0],
        [1,1,1,0,0,0,1,1,0,0,0,1,1,1],
        [1,1,1,0,0,0,1,1,1,1,1,1,1,1],
        [0,0,0,0,0,0,0,0,0,0,0,1,1,1]
    ]
}
  