{
    "start": [3,1],
    "end": [3,13],
    "x_btn": [],
    "o_btn": [],
    "split_btn": [],
    "map": [
        [0,0,0,0,0,0,1,1,1,1,1,1,1,0,0],
        [1,1,1,1,0,0,1,1,1,0,0,1,1,0,0],
        [1,1,1,1,1,1,1,1,1,0,0,1,1,1,1],
        [1,1,1,1,0,0,0,0,0,0,0,1,1,1,1],
        [1,1,1,1,0,0,0,0,0,0,0,1,1,1,1],
        [0,0,0,0,0,0,0,0,0,0,0,0,1,1,1]
    ]
}