{
    "start": [4,2],
    "end": [1,4],
    "x_btn": [
        [7,12,[[7,14,"toggle"]]],
        [2,14,[[3,10,"hide"],[3,11,"hide"],[6,9,"unhide"],[6,12,"unhide"]]],
        [5,1,[[3,10,"unhide"],[3,11,"unhide"]]]
    ],
    "o_btn": [
    ],
    "split_btn": [
    ],
    "map": [
        [0,0,0,1,1,1,1,1,2,2,1,1,1,1,0],
        [0,0,0,1,1,1,1,0,0,0,0,0,2,1,0],
        [0,0,0,1,1,1,0,0,0,0,0,0,2,1,1],
        [0,0,0,0,0,0,0,2,1,1,1,1,1,1,1],
        [0,0,1,0,0,0,0,2,2,0,0,0,0,0,1],
        [0,1,1,2,0,0,0,2,2,0,0,0,0,0,1],
        [2,2,2,2,0,0,0,1,1,0,0,0,0,1,1],
        [2,2,2,1,2,1,2,2,1,2,0,0,1,1,0],
        [1,2,2,2,2,2,2,2,2,2,2,2,1,0,0],
        [0,2,1,2,2,2,0,0,2,2,2,2,1,0,0]
    ]
  }
  