{
    "start": [3,1],
    "end": [1,12],
    "x_btn": [
        [9,9,[[7,2,"toggle"]]],
        [9,2,[[3,12,"toggle"]]]
    ],
    "o_btn": [
        [2,6,[[7,2,"hide"],[3,12,"hide"]]],
        [3,4,[[7,2,"hide"],[3,12,"hide"]]]
    ],
    "split_btn": [],
    "map": [
        [0,0,0,0,0,1,1,0,0,0,0,1,1,1],
        [0,0,0,1,1,1,1,1,1,0,0,1,1,1],
        [1,1,1,1,1,1,1,1,1,1,1,1,1,1],
        [1,1,1,1,1,0,0,1,1,1,1,1,0,0],
        [1,1,1,0,0,0,0,0,0,1,1,1,0,0],
        [0,1,0,0,0,0,0,0,0,0,1,0,0,0],
        [0,1,0,0,0,0,0,0,0,0,1,0,0,0],
        [0,1,0,0,0,0,0,0,0,1,1,0,0,0],
        [0,1,1,0,0,0,0,0,0,1,1,0,0,0],
        [0,0,1,0,0,0,0,0,0,1,0,0,0,0]
    ]
}
