{
    "start": [5,10],
    "end": [7,7],
    "x_btn": [
        [7,1,[[4,3,"unhide"],[7,9,"unhide"]]]
    ],
    "o_btn": [
        [1,6,[[3,3,"hide"],[3,2,"hide"]]]
    ],
    "split_btn": [
        [0,13,[[3,11],[5,10]]] 
    ],
    "map": [
        [0,0,0,0,0,1,1,1,1,0,0,0,0,1],
        [0,0,0,0,0,1,1,1,1,1,1,0,0,1],
        [0,0,0,0,1,1,1,1,1,1,1,0,0,1],
        [1,1,1,1,1,1,1,1,0,0,1,1,1,1],
        [1,1,1,0,0,0,1,0,0,0,1,1,0,0],
        [1,1,1,0,0,0,1,0,0,0,1,0,0,0],
        [0,1,0,0,0,0,1,1,1,0,0,0,0,0],
        [0,1,0,0,0,0,1,1,1,0,0,0,0,0],
        [0,0,0,0,0,0,1,1,1,0,0,0,0,0]
    ]
}
  